111111111111
100000000001
102000000201
100000000001
100020000001
100000000001
100000200001
100000000001
111111111111